14 14 1.5 1.5 1.
############## 
#      #     #
#   ## ## #  #
#   #     # ##
## #### ### ##
#  #    ##  ##
# ## # #     #
#      # #  ##
#### #####   #
#    #  ###  # 
# #  #    #  #
####   #     #
#     ##  # ##
##############